Start (AA),Stop (AA),AA Length,Start (NT),Stop (NT),NT Length,Reading Frame,Strand,Amino Acid Sequence
16307,16441,134,48919,49323,405,1,+,MNGRRARVKCSRSGRQADRLQRSVGLAPPPSLLHDSPVPSMEGRGQCDTPSHHHHPSFYLESFTVTHECSFPPQTFLASPGANTGNSPARWINRRSPLSTPLSEVEAPPRVPRHHSRLTHPPATLAHQLPSPPV*
16565,16440,125,49697,49320,378,3,-,MLDLTSRGQVGTSRRMAEAACSAHFLVGARELGERCGGGAAWRLLRNREVSTGWRVAGVLGWVCEDGVFMIGRRRAGSQRVLGSAGRVGGEPAWSEMEEGALEQPFPPCRTPAPGLGCGARARLP*
16497,16614,117,49489,49842,354,1,+,MKTPSSHTQPRTPATLHPVDTSRFRRRRHAAPPPHRSPSSRAPTRKCALHAASAILRDVPTCPREVRSNMKGKGRQGVQCAPGTPSRGVPQSEGRRSAGTRGGGGQRQYSPVRQSPS*
6114,5998,116,18345,17995,351,2,-,MKLVMFIASSKSFLFFCSQDGVSLCCLGWSAMVRSWLTATSASWVHSHASASQVAGIAGTCHHAHLIFVFLVETGFHHDGQAGLELLTSGDPPTSASQSARITGVSHHAWPKGILI*
6339,6454,115,19015,19362,348,1,+,MKIQLTSKTAKMRPGAVAHACNPSTLRGRGGWIMRSGVQDQPGQHGETPSLLETTKISRAWWHTPVVPATREAEAEESLEPGRWRSSLGDRARLRKKKKQMAKMLFFPLYIFYFK*
14498,14605,107,43492,43815,324,1,+,MLVRFVMIPQKFTEYSVTKLHFPVFSFFFFFFFEKEFQSCCPGWSAMADIGSPQPPPPRFKRFFCLSLPRSWGYRHVPPYPANFVILLSRDRVSPCWSGWSRTPDLR*
5652,5552,100,16959,16657,303,2,-,MPSLFYFILFYFIGDGASLCHQAGVQWCDLGSLQPPPPRFKRFSCLSLLSSWDYRRVPPRLANFCIFSRDGVSPCWPGWSRSLDLMIHPPWPPKVLGLRA*
8830,8739,91,26494,26219,276,1,-,MTVYSALGLLNYNTEHFYLKLINSANLKPGLILCSQIGYLFLFPHLPFVFNLFDLLVNGFHCPQDERYTFSLTFEAFNSLTPTYHSSSLVS*
3311,3221,90,9936,9664,273,2,-,MEFDLKMPTSFLNLFFFFEMESSSVTRLKCNGVISAHCNLRLLGSSDFPASASLVAGITGACHHARLIFVFLVETGFHHVGQAGLELLTS*
15114,15201,87,45340,45603,264,1,+,MESCSVAQAEVQWYHLGSLQPPPPGSSDSPALASPVAGITGACHQAWLIFVFLVETGFHHFGQAGLEHLTSSDPHPPRPPKVLRLQA*
4208,4294,86,12622,12882,261,1,+,MLCLLHNRFPAIPRDPRHTETHHSTEFTEMTQRDNYSVLSALTEISKHSYLRKTQQSWARWFTPVIPALWEAEVGGSPEVGNSRPA*
13630,13544,86,40892,40632,261,3,-,MWKTYLLPIFPNHLIPLSKLPNYNFLRILLEKVCPGELSEIMERVFFTVQYSSHWLYMVIEHLDIVACATKEINFKLYLILIINHM*
10580,10665,85,31739,31996,258,2,+,MSHRTRPKTWMNPFFFPFETESCPVAQAGLQWRDLGSLQLPSPGFKQFSTSASQVAGITGACHHARLIFVFLVQTGVSPSWPDWS*
4525,4440,85,13577,13320,258,3,-,MQHYSIFIIFPVRYLIKYRITFNSFPTPGTLISSWLICSSEKYQPTCFSPSFFFFFFETEFPSVALAGVLWHNLGSQQPPPLGFK*
12078,12160,82,36234,36482,249,3,+,MGQQPISYFCKLLFFFLRQSLALSPRLKCNGVILAHCNLHFPGSSNSPASTSQVAGIIGTRHHAQLIFCIFSRDGVSPCWPG*
7287,7368,81,21860,22105,246,2,+,MCCKPPYLRINHLLGFHDHHCLFFFFLRWSFALVAQAGRQWRDLSSLQPAPPGFKQLSHLSLPSSWDYRRLPPYPANFCIF*
6117,6036,81,18355,18110,246,1,-,MKFNETGNVYCLIKVIPFFLFSRRSFTLLPRLECNGAILAHCNLRLLGSFSCVCLPSSWDCRHLPPCPSNFCIFSRDRVSP*
14984,14903,81,44954,44709,246,3,-,MRACNPKVLRRLRQEKLLNLGGGGCSELRLCHCTPTWVTERDSVSKKKKINKRSFLNLLVPVSCTILVIETFLRSGNEHGL*
10167,10087,80,30504,30262,243,2,-,MKKKQNKKERKKMRAEDGENDAIKKQAESLRESQVISLVCQHRLEAAYTVLWQILESEKDLEEAEEYKEHLVLDSVELEA*
3577,3654,77,10731,10964,234,3,+,MLLIKNKYSQSLLSNECSQILSKFMVLIVCFAFFSNTNEYKISIRSQALEIYRKILFLLLKMYIHMYKFYTTIYFFV*
4703,4778,75,14108,14335,228,2,+,MLFVSILHSRISFKIGVNPPKPCSCFINLVYVIFKSFVVTSTMFTASSPGIDSISRNLFFCSPIRSNTLSIQVFS*
8910,8985,75,26729,26956,228,2,+,MFKSTLLKFQNHDVLFHSFEHSRFLSNSQPKYTYKPLLEIMMSLSPQNTPFVSSITFIQQISTYSQELPKNFFPG*
12217,12143,74,36653,36429,225,3,-,MSRSKVLRRKSKGDWGTYCTMKKSIIKDNGQAQWLTSVILALWEAEAGGSPEFRSSRSAWPTWRNPISTKNTKN*
1868,1794,74,5606,5382,225,3,-,MSKTRSYFICSFRNTSVCRSCFPCIVFVNTFIILNGSIGAQRLVFLGFFTAIYLFIYLEIESHSVVQAIYSTVA*
14917,14990,73,44749,44970,222,1,+,MTKMVQLTGTNRLRKLLLFIFFFFETESRSVTQVGVQWHNLSSLQPPPPRFKSFSCLSLLSTLGLQARITTPS*
12587,12659,72,37760,37978,219,2,+,MAAMIKMPIFIILPFLNTHTHTHTHTHTHTHTHKKNPNAQVSSPDFYLYLILLDHVFMKFLFSPLCPANCIR*
16346,16275,71,49040,48825,216,3,-,MLGTGLSWRREGGGARPTDRCSRSACRPDLLHFTRARLPFIHPFRVVRTPQRMRMGLNPSVLPSLYLLEDF*
502,572,70,1504,1716,213,1,+,MDSGDVYCNSLIGIVETLAKKKKKNEHRSTRQRRMRLLLYLSNIKMEIKFKCSPLCFLKRLWFSSQISIA*
8014,8083,69,24041,24250,210,2,+,MQSRKVVNIYLKEYGFFFFLYFIFLRDGVSLIAHCSLNLPGSSNLLASASTVTGTTDRHHDTWLILFYF*
13341,13276,65,40025,39828,198,3,-,MVSHSVVRLECSGTISGHCNIHLPGSGDSCLSLLSSWDYRCAPPLPTNFCVFSRDSISPRWLGWS*
6261,6197,64,18785,18591,195,3,-,MWNLKPYPRIFFYFVTLKSIGLSVSCIWNGSLTCVRFLTSYTAYLENNGSVSYADLPMLTHFLI*
12290,12353,63,36868,37059,192,1,+,MVPLHSSLGNRVRLCLKKKVYVLPQRNKLRFCMYITITGSYKNEHSEDKKKKKRKRRRMGGRK*
11396,11459,63,34188,34379,192,3,+,MSHHAQLIFRDRSHYIAQPGLKLLASSDPPASAFEVARITGMSHHTCLFMYQGFKITFQKKIF*
6871,6808,63,20617,20426,192,1,-,MAPILAVFSLFTSCILLSSLPRVVNVKFGLYSRSIKCTYVYFLIHTSIQLTFLFVCAYFTSLF*
1408,1470,62,4223,4411,189,2,+,MPFSCLSLPSSWNYRRPPPRPANCFFCIFSRDGVSPCWPGWSQSPDLVIHLPQPPKVLRLQV*
10484,10546,62,31452,31640,189,3,+,MDSFFFFETDSHSATQAGVQWHDLGSLQPPPPGFKQFSCLSFTSSWDYRHAPPHLANYLYFK*
16362,16300,62,49090,48902,189,1,-,MRDGGGEKGYHIVLAPPCLGLGCHGGGKGEERGLQIAVAGRLAGRTCCISHAPVFHSFILSA*
7146,7084,62,21441,21253,189,2,-,MRINLSSLNADGGKKMAVQKHCNNLEESKLELTSEVLEVFQFISCLFLFLFTFFRADHSLST*
10035,9974,61,30109,29924,186,1,-,MTKLRTNSRYYKEQKRMKSVYIFVLNNVLIKVICTHKRGFYLHLPVYVRYLTNGYLVSCCA*
2503,2443,60,7513,7331,183,1,-,MIEVFATLLQHCYMYTKLLNTYIFRARVLLCCPGWSADIYLYGSFQPHPLGSSDPPTSAS*
6274,6214,60,18825,18643,183,2,-,MLKEILGFLEASCNVESETISKNFFLLCYIKIHWSVSVLHLEWISYLCKIFNIIHCLFGK*
1276,1335,59,3827,4006,180,2,+,MAKPCLYKNYCSGSGLWSQLFRRLRQENHLNPRGGGCSELTSRYCTPAWATECDSVSKN*
9323,9264,59,27972,27793,180,2,-,MTLYCINHYCSGRNTYIYIYQKEFRKEESDKYNLKNFFLSKTNHMKQLSIVAGHIVCSE*
16147,16089,58,48444,48268,177,2,-,MVYQFALTFKDFFFFFFFFFFLRWSLALSPRLECSGVISAHCNLRLRVQAILLLQPLE*
7864,7806,58,23594,23418,177,3,-,MLFCFVLFVFETGSCRVAQAGLKLLGSSNPPINPPINLPSSWDCRDAPQCPVIQLLYS*
1884,1941,57,5652,5825,174,3,+,MCNSFSVFTFSSPYCYLITFSSNINNSATYIITVVIKRFSNKAQKLKKKSQITFNRL*
12983,13039,56,38948,39118,171,2,+,MWWWTPVIQLVGRLRQENCLNPRGGGCSEPRLSLHSSLGKSKAPSWKKKKKERKKN*
13172,13228,56,39516,39686,171,3,+,MCQKSAHSWLLFTFYKYTYLLYMHKSLLKVKQLTMLVASRSSAWIGISFRRLCTFA*
1954,1898,56,5866,5696,171,1,-,MQIQKRHLQCNELVYNLLNVIWDFFLSFCALLENLLMTTVMMYVALLLMLELKVIR*
2422,2366,56,7269,7099,171,2,-,MGSCYVAQVGLKLLASSDPPTSASQSAGITGVSHCACPTKLFRLVKQIIKLLCTTI*
4314,4369,55,12942,13109,168,3,+,MPVFPATWEAEAGGYGELRSRHCTPAWATRAKFHLKKQKNKQKKKTKKTQQTLKL*
5794,5849,55,17382,17549,168,3,+,MSLPKKKKKKKKKSQACWFMPVIPVFCEAEVDELLESTSSRPAWEIAKLQLYKKY*
8520,8465,55,25562,25395,168,3,-,MCSSFFKLLEKYKIMCPFLFCFETEFCSCRPGWRTVARSVLTAISASWVQAILLP*
544,489,55,1634,1467,168,3,-,MLLRYKRSLIRLCLVLLCSFFFFFLARVSTIPIKELQYTSPESINVFLAHSVIVQ*
9780,9834,54,29338,29502,165,1,+,MVLYDFEKLTPHPNYEFLLDREHLLSSNYQAMCYIIFIHIISTYYKSSQYSQSS*
1571,1625,54,4713,4877,165,3,+,MTAPLHSCLNNTVRPCLKKKKKATFAKNKIYKKRFNKTLHMWVLNMEQKPRYVI*
4956,4902,54,14872,14708,165,1,-,MTVHRFIAWFTEYFKPTVETYCPEKKFPFKISLLLDDAPSRPRALTEMNCFHAS*
6356,6302,54,19071,18907,165,2,-,MSHRTWPHFCRLRSQLDFHSCFCLQSMELRCFIGSIRRQYSLTQVFGWKRENSF*
10691,10637,54,32075,31911,165,3,-,MCWARWLTPVIPALWEAEAGESRGQEFKTSLAKMVKPLSVLKIQKLAGRGGRRL*
4800,4746,54,14402,14238,165,3,-,MCREQETNSKKWSLKMLLNCCSLMRKLEWIRCCFLWVSRKKGFLRWNLFLVKML*
10506,10559,53,31516,31677,162,1,+,MISAHCNLHLLGSSSSLASASRVAGTTGMHHHTWLIICILSRDEVSPLWPSWS*
13671,13724,53,41011,41172,162,1,+,MLKHSFFFFFFETEFHSCCPGWMQWHHLGSLQPPPPRFKQFSCLSLSWDYRHP*
15475,15528,53,46423,46584,162,1,+,MHDGISRKSPWLFLSVYDYAQQKTIMEAHKLAEVRKNMIFAAFSRGISSTIQF*
13360,13307,53,40084,39923,162,1,-,MFFFVFFFFASLFVSVFVLRWCLTLLSGWSAVARSRVTATSTSRVQVTPASAS*
2797,2744,53,8395,8234,162,1,-,MRALIIQSTPSFIYLSRLSLSSILNLRSMGPWNTYYWALSVGRGTGHSLTEIA*
386,438,52,1156,1314,159,1,+,MLHEEKNKSKTNEKLKSESLILSSRETNKLKSSSHQQEYSKDNAVKRNKENC*
3984,4036,52,11950,12108,159,1,+,MVTYAQKSSTVSNLEISRRFACQVLLLSFLKNQSAHLKIKNQCQKMVAAYPC*
7539,7591,52,22615,22773,159,1,+,MFNIVFWVSNLLIRFRFLLFCSRGIRSRGGFLVENNIKHYFKCLNTSMTAIF*
11570,11518,52,34713,34555,159,2,-,MFSAYIINAVVCLSVTFWLYLLIDVLSLRSLITRLKNVDVFILILLFFYFPI*
11097,11045,52,33294,33136,159,2,-,MESCFRYAGVQWCDLSSLQSLIPWFKRFSCLSLLRSWDYRHAPPRPANFCIF*
4186,4237,51,12557,12712,156,2,+,MLVVITVANNESSPFLSFKRYVCYVYYITDSLLYLETQDTLKLITQRNSQK*
10146,10197,51,30437,30592,156,2,+,MASFSPSSALIFFLSFLFCFFFMHHFFSTNCFTTGVLICLRTGSAMVPQAP*
13960,14011,51,41880,42035,156,3,+,MNSSPIKYSFIHQKKNYKKKYTFHISIKISNFLALVNTSDQILCQHRLTAP*
14784,14733,51,44356,44201,156,1,-,MSPEKERGWAWWPTHVIRGFGRQRQEDHLSPEFETSLANMARPCLSKKLKN*
1570,1519,51,4714,4559,156,1,-,MAHFSLNLLGSGDTPTSATQLAATTGVYDHTWLFSCIFCREEVLPCCPDWS*
348,297,51,1047,892,156,2,-,MHFIQISDLCLCDFLNIIVDYKKCNIIITFLTRISMSVFVSLCCILTLCIT*
5655,5604,51,16967,16812,156,3,-,MPSCLAYFILFYFILLEMEPRSVTRLECSGAISAHCNLRLPGSSDSPASAS*
16611,16561,50,49837,49685,153,1,-,MATVEPVSIAFGPHPHGSPRSVFLLTGGLRGTAFPARTVPLAAPSPSCWT*
11477,11427,50,34433,34281,153,3,-,MKLMTIPGFVNFFKVYISSKYFLLKGDFKTLVHKKAGVVAHACNPSNFEG*
12152,12201,49,36454,36603,150,1,+,MGFRHVGQADLELLNSGDPPASASQSARITDVSHCAWPLSLIILFFMVQ*
13491,13540,49,40471,40620,150,1,+,MGFHHVGQAGLQLLTSSAPPATASPSAGITGVSHHARPEFLASEAILHN*
9947,9996,49,29841,29990,150,3,+,MVHLTLPPRHTKKPTTRKKSNYIVSLYYYAQQDTKYPLVKYLTYTGKCK*
11317,11366,49,33951,34100,150,3,+,MCSFSKVKGYNFNVNCSFNKVILFSVTTSYPTNFFFLLFLPSEEGITIT*
14447,14398,49,43343,43194,150,3,-,MLSTTLNALHILTHLFLFFFFLRQRLTVVPARVQWRDLGSLQPPPPGFK*
7315,7363,48,21943,22089,147,1,+,MEFRSCCPGWQAMARSQFTATCTSWVQAIISPQPPEQLGLQASATIPS*
2770,2818,48,8310,8456,147,3,+,MLLRLRMLDKLSLLKYIKEGVDWIIKALIKINLSMCPQSNSLSIFINK*
11146,11098,48,33442,33296,147,1,-,MEIIMLLQSTVLCTGCNAILVLIYFESFFYFCIMFNVCKFFFSLWFFF*
9704,9656,48,29115,28969,147,2,-,MSHQSCCYPLFGAVALTEHVYIFVSSGRGRVLVSELFRCGNSNLGNYF*
13847,13799,48,41543,41397,147,3,-,MDGGIRRVKFFSFELVYFVTMLWIVKSVLDVGLYIMVFSFSLFFVFFL*
10293,10340,47,30877,31020,144,1,+,MKVWLWILQSSLSVIKDQNYDFYTPPLTEKVEIKNTWRFSKIQIFQH*
4617,4664,47,13850,13993,144,2,+,MSEIALHLKKNVHTLIKNSIAKNANDHLSLQRVVILLMEGLPLFAAD*
6256,6303,47,18767,18910,144,2,+,MVSDSTLQLASKKPSISLSMCPTKKGGEKRNLVVYQRSISTIIFKGF*
15092,15045,47,45279,45136,144,2,-,MSMIIRLREIQCRHTVYTQKLQRDNMQNELCKLTLVWTENCRQKTFK*
12476,12522,46,37428,37568,141,3,+,MKLDFRILKNSMSSQTTGMTLNIQGLKNFFTMYFFSKNCWRSGPPT*
6678,6632,46,20037,19897,141,2,-,MICGFYLRTDYSVLLFFFFWIIFFFPYFQANKLWNIFSSLFPSILY*
768,722,46,2307,2167,141,2,-,MFVLQISVFKYACDTGLSCICDYLIMFSLLDYKCSQLRDCPYFVHC*
15573,15527,46,46721,46581,141,3,-,MESRDGYPGWSQTPGLKWSSHLGLSICWVTGVSHRASPGFFFEATD*
10929,10974,45,32785,32922,138,1,+,MTNMVKPHLYQKHKISWAWWRMPVIPVTWEAEAGESLEPGRGKLQ*
14664,14709,45,43990,44127,138,1,+,MTISILDTHTHTQNHFLFLFFFGEIGSLSVTQAGMQWCDHSSLQL*
1766,1811,45,5298,5435,138,3,+,MRLYSQLLGRLRHNNLLNPGGGGCSEPRSCHCTIYSLDNRVRLYL*
14185,14140,45,42559,42422,138,1,-,MISQLKYFASEKSFSTFLKVCEFWIYSRLNYLSTFSNFGDKSGKG*
10737,10692,45,32215,32078,138,1,-,MGFLHVGQAGLKLPTSDAPPASASQSAGITGVSQCSQPPTTLSSS*
3639,3594,45,10921,10784,138,1,-,MYIFNSRNNIFLYISSAWLLIDILYSFVLLKKAKHTIKTINFESI*
1765,1720,45,5299,5162,138,1,-,MPPCLGNFYIFSRDQVLPRWPGWSFNFWSQVIRPPQPPKVLSLQA*
11057,11012,45,33173,33036,138,3,-,MHHHAQLIFVFFSSGWVSLCWPGWSQFPDLMIHPCWPPKVLGLQA*
2436,2391,45,7310,7173,138,3,-,MPPCPANFLIFFQRWDLAMLPRLVSNFWPQVILPLQPPKVLELQV*
13813,13857,44,41437,41571,135,1,+,MMYKPTSKTDFTIHNMVTKYTSSNEKNLTLLIPPSINHLAYSFS*
6858,6902,44,20574,20708,135,3,+,MQEVNNEKTAKIGAIKHSIFPNDTCYFTQKVEFIEKLKSPETSF*
3250,3206,44,9754,9620,135,1,-,MPPRPANFCIFSRDRVSSCWSGWSRTPDLMIHLPRPPKVLGLQA*
14517,14473,44,43554,43420,135,2,-,MKFSHTIFSKFLWNHYKSNQHWIYRDMELRIWIYSCKQLTKKTL*
12550,12506,44,37653,37519,135,2,-,MFLILSFDFCVPPFHLLCPLSSCYLVSYLTLVGQISSSFLRKST*
6543,6499,44,19632,19498,135,2,-,MIFYLNQQYSSIWSHNSFTLLKIIGDSTELYVDFYLLLFTIFLQ*
14851,14807,44,44555,44421,135,3,-,MFYTHVYPCIYILFSLFSWKFTLLLFNYQSLAISKKCKACDSQS*
1543,1500,43,4632,4501,132,2,-,MTTPGYFLVFFVEKRFCHVAQTGHELLDLIKPPQPFKVLRLQA*
15761,15718,43,47285,47154,132,3,-,MNFFFFDTDFHSCCPGWSAMARSWLTATSASWVQSILLPQPSE*
10505,10462,43,31517,31386,132,3,-,MPLHSSLCGRVRICLKKKKRIHPSFKTVYLKIRNASVDCWDFF*
201,243,42,602,730,129,2,+,MILPIQFIKNCNKHNNQTSAPNLCCSHGRHHKRRHNIETALQ*
1682,1724,42,5045,5173,129,2,+,MNKKCYMPKESALVVIYFTAKKKQFYRNKKHMKKARRSGSCL*
12801,12843,42,38402,38530,129,2,+,MEEGPKIQECDHGSIKKAEMLLWCPRSWYMCLQFTTLKPGQA*
8441,8399,42,25326,25198,129,2,-,MGFHHVGQAGLELLSSGGALALTSQSAGITGVSHHARPIMCS*
5809,5767,42,17430,17302,129,2,-,MPGFFFFFFFFFLEETWSHSVAQTGEQWHDNSSLQPQISGLK*
13535,13493,42,40607,40479,129,3,-,MASEARNSGRAWWLTPVIPALGEAVAGGALEVRSWRPAWPTW*
4839,4880,41,14515,14640,126,1,+,MNVLNDIQNAQSFRKVFHLLCPDPSKESLSTAFSLMKYSSY*
9680,9721,41,29040,29165,126,3,+,MTQKYKRVRSMLQHQIMDNNMIGDSYPVVLPYITPSFTFCS*
15698,15657,41,47098,46973,126,1,-,MGFLHVGQAGLQLPTSGDPPVLASQSGGITGMSHRAWPENF*
10820,10779,41,32464,32339,126,1,-,MFFKKIYFKMLKGDHKSSFFFFFFFFETEFRSCCPGWSAVA*
157,197,40,469,591,123,1,+,MVMHQIPILMSINILREYIIYLRLNDCALLYKKTKIATSI*
9251,9291,40,27751,27873,123,1,+,MLSEWLPGLPFSKYLFRANYMTSHYAELFHMICFRKKKIF*
9067,9107,40,27201,27323,123,3,+,MSSSLSFYKSIILEIFKKRPGMVAHPCNPNTLGGQSRRIS*
4772,4732,40,14319,14197,123,2,-,MDKVLLLMGEQKKRFLEMESIPGEDAVNIVEVTTKDLNIT*
9536,9496,40,28610,28488,123,3,-,MVADSYGSLQCQTLGLLMKTHTALFTREETDPYRDFKDLP*
3446,3406,40,10340,10218,123,3,-,MCGPLPNFCFFLANLLQITIESFCIYPDCIVLGFCLDVPL*
552,591,39,1656,1775,120,3,+,MQSTLLFEEALVQLPNLDCLTQSPMRILRRCLLKQQTYF*
4114,4075,39,12346,12227,120,1,-,MNLTSYTSYKWNHTVFVFFGGGLAYSLNVLSFPSCFMKC*
9072,9033,39,27219,27100,120,2,-,MIKMKTCIQYVSLNLISFSRYKIVKLLQIFKVFTLHFYT*
4905,4866,39,14718,14599,120,2,-,MPLNTVYFLQRMEQQRGILTFKPYYLLIRTIFHEAKCCR*
6007,5968,39,18023,17904,120,3,-,MPGPKAFLYETHIISTVRVGSNKCTVTTRIVLCHCLGSC*
6051,6089,38,18151,18267,117,1,+,MGMVAGACNPSYLGGRRMRMNPGGGGCSEPRSHHCTPA*
12332,12370,38,36995,37111,117,2,+,MNIQRTKKKKKGREGGWEGENKYLEIQNEWKLKMKVEK*
16185,16223,38,48554,48670,117,2,+,MHTRYLHLAVSFLKRQQGPEVSVSQSWQTQIMKNIPSA*
6445,6407,38,19339,19223,117,1,-,MGRTAFLPSVFFFFGVSPCRPGWTSTSRVQAILLPQPP*
3769,3731,38,11311,11195,117,1,-,MLRQEDHLQPGVQDQPGQHESLFLYKINKNCKVYFKKF*
9544,9506,38,28635,28519,117,2,-,MSSQVLIAHGSRQLWITSVPNSWIVDENPHGTFYKGRN*
3641,3603,38,10925,10809,117,3,-,MYVHLQQQKQYFSVYFQCLASNRYFVFICVAEKSKAYD*
9457,9494,37,28369,28482,114,1,+,MGSSTRQPGSTSNPNLMSPLSLKMSMIGENFQSTIGI*
10197,10234,37,30589,30702,114,1,+,MRRVGQRARVIMEEAAVSPQFFSTNHAFPHSTLKYVN*
15421,15458,37,46261,46374,114,1,+,MFPLIFPFKLLNKFNICGPHLHVTQLIQRENHTIISN*
6002,6039,37,18005,18118,114,2,+,MPLGQAWWLTPVILALWEAEVGGSPEVRSSRPAWPSW*
7245,7282,37,21734,21847,114,2,+,MFYGTTLWNLTKKLFPKSARTFLKVFNPMDILTSCFI*
7418,7455,37,22253,22366,114,2,+,MSILHRHSSSTKASYMMLVSPVFVLSQVHFSLRELIY*
5682,5719,37,17046,17159,114,3,+,MIMPLHANVSDRARPCQGMGQGWGQGQGMEGEGERTA*
2344,2380,36,7030,7140,111,1,+,MLIISYLICLVKPEVPVNITTCRSNGSTQQFYYLLH*
12711,12747,36,38131,38241,111,1,+,MSMIMPTGFPKKGSSRNSRKLKPNYKPKTVFRLSFL*
10327,10291,36,30985,30875,111,1,-,MCFLFQLSRLREEYKSHSFDPLLQIRKTAKSTATLS*
7302,7266,36,21910,21800,111,1,-,METKKVVYSKIGWFTAHVLKRSNEARCQNIHWIEHF*
5263,5227,36,15793,15683,111,1,-,MANLIDKCCMCSDCSTDWPFPSSCPWACLFPETQQC*
11249,11213,36,33750,33640,111,2,-,MLDQAGLEHLTSGDPPASASQNAGITGVSHHTRQNT*
2633,2597,36,7902,7792,111,2,-,MWEDEKNKRGGRWLITLNKQQRRSDLDRFWLETVRF*
1407,1371,36,4224,4114,111,2,-,MNPGGGACSEPRLGHCAPAWETERDCLTKKKKKKKI*
6598,6562,36,19796,19686,111,3,-,MVFFFLEVFNFHVGKYCFSSVVSGFHINFRKTLPHS*
13574,13609,35,40720,40827,108,1,+,MYSQWLLYWTVKNTLSIISESSPGQTFSSRILKKL*
1199,1234,35,3596,3703,108,2,+,MLEETLKYDDKSTLFSYGTPYSMKCRKSLYLLIQK*
7769,7804,35,23306,23413,108,2,+,MQQSWENLLSFLTYHHIKILHMVLKGVSGRIQDGN*
9946,9981,35,29837,29944,108,2,+,MNGTPHPSSQTHKKTHYQEKKQLYSEFVLLCTAGH*
16305,16340,35,48915,49022,108,3,+,MNEWKTGACEMQQVRPASRPATAICRPRSSPFPPP*
4033,3998,35,12103,11996,108,1,-,MGMQLPFFDTDFLFLDGHSGFLKMIKAKLGKQTCG*
875,840,35,2629,2522,108,1,-,MRLESPCYTVSQPLCLLFGTHDKCHFILAIESCLT*
306,271,35,922,815,108,1,-,MLYFNTLYYLGYFALVKNGSSRKAVPFILRQCTKL*
16360,16325,35,49083,48976,108,2,-,MVVVRRGITLSSPLHAWDWAVMEEGRGRSEAYRSL*
9180,9145,35,27542,27435,108,3,-,MGNMALEGVIRSSASHILMTIWFVFVFKVSFHLIF*
6836,6801,35,20510,20403,108,3,-,MHICILFNTYVYTVDFSVCMCIFYLIVLNHRLALY*
5244,5278,34,15730,15834,105,1,+,MGMASQWSSQNTYNIYQLSLPSYIANVHGTPKQL*
5782,5816,34,17344,17448,105,1,+,MPLLPSLGDRMGPCLFQKKKKKKKKKARHVGSCL*
9610,9644,34,28828,28932,105,1,+,MLSKLLSWLNNFYLSSDPYTRPSPPSPHPQSYTQ*
12828,12862,34,38482,38586,105,1,+,MVHVSSVYYSKTWPGVMAHTCNHSTLGGQGSRTA*
4840,4874,34,14519,14623,105,2,+,MFLMTSRMLNPFGRFSIYFVQIHQRNHYLQHLAS*
5855,5889,34,17564,17668,105,2,+,MPVGPQLGWKDGLGTEGEGCSEPRLHATPAWVTE*
8857,8891,34,26570,26674,105,2,+,MSGSFLLHSAKISTGIILILQDNPNIIEVNISQI*
4967,5001,34,14901,15005,105,3,+,MGRVDLASFFRILKILGMANEHWLQLKVIGCKIP*
16124,16090,34,48376,48272,105,1,-,MESCFVAQAGVQWRDLGSLQPPPPGSSDSPASAS*
9187,9153,34,27564,27460,105,2,-,MAELGFQHGEHGSRGCDQKQCISYSDDNLVCVCF*
8727,8693,34,26184,26080,105,2,-,MNTAPSHGLALTPYSTHLKFVTRCFFKGRLPILG*
7419,7385,34,22260,22156,105,2,-,MDIQRQWWSPNAVAHACKPSTSGGGGGGGGGRIT*
7280,7246,34,21843,21739,105,2,-,MKQDVKISIGLNTFKKVRADLGKSFLVRFHRVVP*
5317,5283,34,15954,15850,105,2,-,MFPMACAHLVSLCHISVILTIFQTFIVSVMICDQ*
10620,10586,34,31862,31758,105,3,-,MEVAVSRDRATAIQPGQQGKTLSQREKKKDSSKF*
1218,1184,34,3656,3552,105,3,-,MGFHKRKELICHHILMFLPASKPNFGGFTFFFFK*
15614,15647,33,46840,46941,102,1,+,MIAPLHSSPSNRARSCTPTHKIQLFKTVKNNST*
367,400,33,1100,1201,102,2,+,MHKINVYSTFVSYSWILHQCYMRKKTKAKQMKN*
3371,3404,33,10112,10213,102,2,+,MDIVGMTFNKILFPFCCLLSLLWCSKVSQVSPS*
3408,3441,33,10223,10324,102,2,+,MAHLNRILRLCSLDKYKRTQWLSAINLLEKNRN*
5683,5650,33,17053,16952,102,1,-,MIIAHCNLELFGSSNPPALASRVAGTIDTCHHA*
2078,2045,33,6238,6137,102,1,-,MIPLHSSQGDRARPCLKQQQQQKTRPLTNIHKK*
9115,9082,33,27348,27247,102,2,-,MLLFWPPGLKRFSCFGLPRCWDYRDEPPCLAFF*
5027,4994,33,15084,14983,102,2,-,MPSSRTLLVREKSLPSFKATKDRLTLVRGSCSQ*
13147,13114,33,39443,39342,102,3,-,MVYVTLFGFNIIISILIFRSFPTICYFKHYWDK*
13272,13304,32,39814,39912,99,1,+,MRSRDQDHPSQRGEMLSLLKTQKLVGSGGAHL*
3792,3824,32,11375,11473,99,2,+,MQKLMIPILNFLLYRNKISKIFQLFFLRLIKV*
3870,3902,32,11609,11707,99,2,+,MRTQQRTAIPSYEANVSWQPGVEQVPTSCQKF*
5568,5600,32,16703,16801,99,2,+,MRSRDRDHPGQHGETPSLLKIQKLARRGGTRL*
9416,9448,32,28247,28345,99,2,+,MLQLTVCIYQALTSLLQFSSHNRKSNPRFISP*
3222,3254,32,9666,9764,99,3,+,MRSGVRDQPDQHDETLSLLKIQKLAGRGGMRL*
8226,8258,32,24678,24776,99,3,+,MKTMRDWQAGRLWGTGYQRKTAVDEKWAPQYM*
13569,13601,32,40707,40805,99,3,+,MLNYHVQPVATVLDSKKYPFHYLRKFSWTDFF*
13817,13785,32,41455,41357,99,1,-,MLVYTSWYLAFLYFLFFFFDLVTYSWSKIAIW*
9699,9667,32,29101,29003,99,1,-,MLLSIIWCCSIDRTRLYFCVIRKGESVGIRII*
8929,8897,32,26791,26693,99,1,-,MFKTMEKHIMVLEFKQCRLEHDEENLKFSQIY*
5812,5780,32,17440,17342,99,1,-,MNQHAWLFFFFFFFFFGRDMVPFCRPDWGAVA*
16502,16470,32,49509,49411,99,2,-,MRGWCLHDRKAQGRLPASTGIRRQGGRRAGLE*
8120,8088,32,24362,24264,99,3,-,MSYVDKKKHIPWEAKVGGLLELRSLRPAWPTW*
15028,15059,31,45082,45177,96,1,+,MSHRTRPIFLTLCKLNNILLKCFLPTVFCPN*
2226,2257,31,6677,6772,96,2,+,MIFPLKNRIFFLKSHSFISWLCWHAPVVPAT*
16340,16371,31,49019,49114,96,2,+,MTAQSQAWRGEDNVIPLLTTTIPHSTWRASP*
5313,5344,31,15939,16034,96,3,+,MPLETWHQQNCLTQDFHKPSIYRKGMICEAQ*
14625,14594,31,43878,43783,96,2,-,MGRAWWLTPVIPTLWEAEVGGSPEVGSSRPA*
3428,3458,30,10282,10374,93,1,+,MVICNKFARKKQKLGSGPHIYRKLKNPSYL*
4778,4808,30,14332,14424,93,1,+,MRLQQFSNIFRLHFLLLVSCSLHICSYFFH*
5925,5955,30,17774,17866,93,2,+,MWSADRQEALRSIFIIMLRRHFAFQYSHLH*
9354,9324,30,28066,27974,93,1,-,MMPSVQKRGNRVSGSTFKSRKSRFPYFNLL*
9204,9174,30,27616,27524,93,1,-,MRKLRPRKLLALNFTAVNGRAGIPTWGTWL*
5418,5388,30,16258,16166,93,1,-,MKYIFNLEGSSDNIRVDEKMKFPFDCPLVL*
5363,5333,30,16093,16001,93,1,-,MFHEFIFKALEKILYRRTSFYCASQIMPFL*
16183,16153,30,48552,48460,93,2,-,MGFISNQKTFHTLEPALDLGCQILLCIFSW*
13872,13842,30,41619,41527,93,2,-,MLGLILMRRYTNKCKILTERICQMVYGWWD*
11650,11620,30,34953,34861,93,2,-,MRHHAWLIFVFLVETRFHHVGQAGLKLLTS*
9790,9760,30,29373,29281,93,2,-,MRCELFKIIKHHPFLFLLCLSFCSLFHTFI*
7884,7854,30,23655,23563,93,2,-,MKVRPAHHWLDHFTKLFCHHNVVLFCFVCF*
7067,7037,30,21203,21111,93,3,-,MISIFLNVSFIHHGRPTEINSSNMLYAVFS*
938,908,30,2816,2724,93,3,-,MTYEALCDLPLKPCQLYLMFTLLTSHSHTA*
4987,5016,29,14959,15048,90,1,+,MSTGFNLKSLAARSPNKSQPVLCSFEARQ*
8507,8536,29,25519,25608,90,1,+,MILYFSNNLKKELHIFKYVCMYESVSILI*
9976,10005,29,29926,30015,90,1,+,MHSRTLNTHWSNISHIQVSVSKNLFYVYK*
2847,2876,29,8540,8629,90,2,+,MVRFLNEYQMAQSYNKYIKSPIKHTLKSE*
8747,8776,29,26240,26329,90,2,+,MVGWSETVKGLKGQAKSVPFILGAMKAIN*
3881,3910,29,11643,11732,90,3,+,MRQMYLGNQEWNKFQLAVKSSKGNNGFLS*
6183,6212,29,18549,18638,90,3,+,MSLEVILMNYYCLILYKKMCQHWKICITH*
13851,13822,29,41557,41468,90,1,-,MPDGLWMVGLGGLNFFHLNLYTLLPCCGL*
12077,12048,29,36235,36146,90,1,-,MRGWADYWNTLSSPGVVSDVYLGFNITLL*
7731,7702,29,23197,23108,90,1,-,MKRYENREWFFRVWSVVCFMKQSALIPSS*
1366,1337,29,4102,4013,90,1,-,MLKLSAGQSVVKMFGLPLCDFSNIINFSF*
11012,10983,29,33039,32950,90,2,-,MSHRAWPYVNFSFSFSSFFFSRRSFALVI*
5938,5909,29,17817,17728,90,2,-,MKMDLRASCLSADHILRTADLNNSLLIST*
13793,13764,29,41381,41292,90,3,-,MVQNSNLVKPIAPILECFKMQARHSGSCL*
4495,4523,28,13483,13569,87,1,+,MRVPGVGKLLNVILYLIKYLTGKIIKIE*
12218,12246,28,36652,36738,87,1,+,MPVIPALWEAEAGGSLEVRSSRPAWPTW*
13125,13153,28,39373,39459,87,1,+,MVGNDLNINIEIIMLKPNSVTYTIRKKK*
6460,6488,28,19379,19465,87,2,+,MSLRLTCDRFSKRIILHFSSFSGEIIHF*
11651,11679,28,34952,35038,87,2,+,MPVIPATWEAEAGESLEPRRRRLQVAVT*
13644,13672,28,40931,41017,87,2,+,MTHANSILVVLQYKLVSFVNLCILCNTC*
9930,9902,28,29794,29708,87,1,-,MSKGVEPEAVEQSTVYIIDLCCLERESL*
15817,15789,28,47454,47368,87,2,-,MWLVIQYLFWYRLWEIWMLCLNLGSRGT*
13766,13738,28,41301,41215,87,2,-,MLVIPALWEAEMGESPEIRSSRPAWPKW*
6874,6846,28,20624,20538,87,3,-,MFYGSNFGSFLIIYFLHFTFFTPQSSQC*
4081,4053,28,12245,12159,87,3,-,MFYEVLEFPSSGLFSIPLCVYIHFSFIC*
1243,1270,27,3727,3810,84,1,+,MAESNGSRLKSQHFGRLRQVDDLRLGV*
1521,1548,27,4561,4644,84,1,+,MTSLGNMAKPLLYKKYKKIARCGHTHL*
2217,2244,27,6649,6732,84,1,+,MWNSKMVFAHDLPPQKQNFLLKKSFIH*
2746,2773,27,8236,8319,84,1,+,MQFQLMNVPSLYQLTKPNNKYSKDPCS*
7866,7893,27,23596,23679,84,1,+,MMTKKLCKVIKPMMRRSYLHGILFTLS*
15943,15970,27,47827,47910,84,1,+,MYILHTYSSLVLCNINVLKSVNCSNNL*
3752,3779,27,11255,11338,84,2,+,MLTRLVLNSWLQVIFLPQHPKVLVLQA*
13435,13462,27,40305,40388,84,3,+,MESCSITQAGVQWCSLGSLQPPPPRFK*
14592,14619,27,43776,43859,84,3,+,MLVRLVSNSRPQVIRPPQPPKVSGLQA*
15568,15541,27,46708,46625,84,1,-,MVTQAGLKLLDSSGPPTLASQYVGLQA*
5312,5285,27,15940,15857,84,1,-,MCSLGVSVSHFGNSHDISNFYCICYDL*
4295,4268,27,12889,12806,84,1,-,MLIRLVSNSQPQVIRPPQPPRVLGLQA*
15694,15667,27,47085,47002,84,2,-,MLVRLVFNSRPQVIRPSWPPKVVGLQA*
14852,14825,27,44559,44476,84,2,-,MNVLYSCISMHLHTIFPLFLEIHIAAF*
10733,10706,27,32202,32119,84,2,-,MLVRLVSNSQPQMLHPPRPPKVLGLQV*
5206,5179,27,15621,15538,84,2,-,MSLTLNQKLEMITLTRKTCQKPTQAKS*
4855,4828,27,14568,14485,84,2,-,MENLPKGLSILDVIKNIHDSWEVRIST*
2741,2714,27,8226,8143,84,2,-,MYFLAVEMYRASKICLLLRKFKNLQIK*
15239,15212,27,45719,45636,84,3,-,MKEPTISEFLDNPRKFGSGVHIPDFFN*
8407,8380,27,25223,25140,84,3,-,MPGRLCVLDMKTIVISYLQWDFYFNSK*
8358,8331,27,25076,24993,84,3,-,MSKDLREREKEDCFFFFLPLSSLGLTC*
5229,5202,27,15689,15606,84,3,-,MLKLSQLIALQWPLHVIVKGRVACLSL*
3778,3751,27,11336,11253,84,3,-,MPVILILWDAEAGRSLAARSSRPTWST*
3033,3006,27,9101,9018,84,3,-,MVRKFIVSGFCFCFCFCFFMFVKKTVY*
4954,4980,26,14861,14941,81,2,+,MHCHPGFVAPFLEHGQSGFSIILQDS*
14191,14217,26,42572,42652,81,2,+,MPEIKLERGRRLSVHPLSLEIHKVLN*
441,467,26,1323,1403,81,3,+,MHHNLSNQQNMLLHKMEQQNFFSCKV*
6913,6939,26,20739,20819,81,3,+,MRTLKNPFLDSIQAVRDICLVYFSPQ*
8921,8947,26,26763,26843,81,3,+,MMCFSIVLNIQDFSATLNLNIHINHF*
12560,12586,26,37680,37760,81,3,+,MFTIYKGQQSRLEQCDSGECDWSNVI*
14846,14820,26,44542,44462,81,1,-,MYIHAFTYYFPSFLGNSHCCFLIINP*
14279,14253,26,42841,42761,81,1,-,MCFAWVTSEGEMCFDKLTMCFATAIK*
6544,6518,26,19636,19556,81,1,-,MYDILFKSAVLKYLVSQFLYTLKNYW*
2107,2081,26,6325,6245,81,1,-,MSLYVCPPTQEAEVEGSFEPRRLRLQ*
7214,7188,26,21645,21565,81,2,-,MRNESQGMWSLKVGWFVSERLEKGTD*
15470,15444,26,46412,46332,81,3,-,MIFVYGHYIKYHFQFDIIVWFSLCMS*
16247,16272,25,48739,48816,78,1,+,MKVCSIDKEKKKVKWKSKFKSFYFQ*
6691,6716,25,20072,20149,78,2,+,MQIENTEIVFPNQTGTNLIGNNLKD*
9557,9582,25,28671,28748,78,3,+,MRHTELDFKLWRSSSPLNFKMRKKF*
16155,16180,25,48465,48542,78,3,+,MKRYTKVSGNQGLELVPECERFSDC*
10074,10049,25,30226,30149,78,1,-,MGSSLHFIIFDHCCVFKCENVILFM*
8704,8679,25,26116,26039,78,1,-,MLFQGKIAYFRVKMCLTTLRLAIIC*
13696,13671,25,41091,41014,78,2,-,MVPLHPAWATRVKLRLKKKKEKRMF*
2110,2085,25,6333,6256,78,2,-,MVTCPCMYAHLLRRLRWKDHLSPGG*
2038,2013,25,6117,6040,78,2,-,MNSYFYYSINICLLINISSSRANEY*
15034,15009,25,45104,45027,78,3,-,MGRVRWLMPVIPALWEAEVGRSPGQ*
4873,4848,25,14621,14544,78,3,-,MRLNAVDSDSFDGSGQSKWKTFRKD*
3403,3378,25,10211,10134,78,3,-,MMDLLERPLSTTEEKGGSKREKVFY*
4056,4080,24,12166,12240,75,1,+,MNEKCIYTHNGILKSPDEGNSNTS*
11058,11082,24,33172,33246,75,1,+,MPVIPATKEAEAGESLEPGNQRLQ*
15713,15737,24,47138,47212,75,2,+,MPVIPATRKAEAGESIEPRRRRLR*
2108,2132,24,6324,6398,75,3,+,MSPYPVNFCIFCRDRVLPCCPNWS*
10121,10145,24,30363,30437,75,3,+,MQLPTCAGKQGLSPGILADFLPAF*
14050,14074,24,42150,42224,75,3,+,MSSSRLTATSTSQVEAILLLQSPK*
15375,15399,24,46125,46199,75,3,+,MALPFSQTNIKPNFDPATIQMPIE*
11436,11412,24,34312,34238,75,1,-,MPVILATSKAEAGGSLEAKSLRPG*
8188,8164,24,24568,24494,75,1,-,MLIKMFGFKALLTVCQFSGLNHSV*
6957,6933,24,20875,20801,75,1,-,MKQTVYLLAVCEPSSWCHFYCGEK*
5534,5510,24,16606,16532,75,1,-,MRSHFVVQASLELLGSSDPPASAS*
15252,15228,24,45759,45685,75,2,-,MPTRLCKLVDFLLNERTHYIRVPR*
14572,14548,24,43719,43645,75,2,-,MPVTPASWEAEAEESFEPGRWRLR*
5854,5830,24,17565,17491,75,2,-,MHHHHFSIFCRVGVLLFPRLALNS*
10533,10509,24,31601,31527,75,3,-,MPVVPATREAEARELLEPRRWRLQ*
76,99,23,226,297,72,1,+,MIPTKSRSSFQVYRIPYYNNLPL*
348,371,23,1042,1113,72,1,+,MHKFVAKLCSYKKQKKLPKNAQN*
11121,11144,23,33361,33432,72,1,+,MIQNISTLKWHYNQCTKLLTAVT*
8662,8685,23,25985,26056,72,2,+,MTSISRFINYLDKKVKANLADYG*
12010,12033,23,36029,36100,72,2,+,MVKKKKRSSQTSEPKYYQRTPSC*
486,509,23,1458,1529,72,3,+,MVILLNYYRVGQEHIYGFWGCVL*
11129,11152,23,33387,33458,72,3,+,MALQPVHKTVDCSNMIISISIIP*
9855,9832,23,29568,29497,72,2,-,MFTFPGLQICLKSGENNGCFTGL*
3791,3768,23,11376,11305,72,2,-,MTLKQNLRLGSVTHACNTNTLGC*
2694,2671,23,8085,8014,72,2,-,MPLALSLMCCLKTTSMAVLWAIK*
13670,13647,23,41012,40941,72,3,-,MYYIKCIGLQRKPIYTEVQQGLN*
13178,13155,23,39536,39465,72,3,-,MCTFLAHCVFSLNMSCRALHINT*
12872,12849,23,38618,38547,72,3,-,MLARLVSNSWAQAVLLPWPPKVL*
11399,11376,23,34199,34128,72,3,-,MVAHACSPSYSVSSLEPRSLRLQ*
4844,4821,23,14534,14463,72,3,-,MSLRTFMIHGRSEYQHEQELGRI*
2956,2978,22,8866,8934,69,1,+,MTGIIFKKTSSDCSDKNIFYVS*
3615,3637,22,10843,10911,69,1,+,MNTKYLLEAKHWKYTEKYCFCC*
2368,2390,22,7103,7171,69,2,+,MVVHNNFIICFTNLKSLVGQAQ*
3188,3210,22,9563,9631,69,2,+,MLTPSRNISGKDLRAGCSGSRL*
3593,3615,22,10778,10846,69,2,+,MFSNTLKVYGFNRMLCFFQQHK*
4532,4554,22,13595,13663,69,2,+,MYTSFNISVYTSLKIVLFLHNT*
15091,15113,22,45272,45340,69,2,+,MLINSDYKMKCEICFCFFFYSF*
3516,3538,22,10548,10616,69,3,+,MKSFFLGGAEDWSYLRVLNKQN*
5150,5172,22,15450,15518,69,3,+,MCLLEEDFRSPSRIFPLLSQPG*
5546,5568,22,16638,16706,69,3,+,MGWAQWLTPVIPALWEAKVGGS*
9254,9276,22,27762,27830,69,3,+,MVTWLAILQVFIQSKLYDQPLC*
10868,10890,22,32604,32672,69,3,+,MTRLMIKFKCHYYLNQRLPEDS*
13694,13716,22,41082,41150,69,3,+,MAPSRLTATSTSQVQAILLPQP*
9639,9617,22,28921,28853,69,1,-,MIGGGVKVGKVWCKDLRIDRNY*
9452,9430,22,28360,28292,69,1,-,MAPSASGTDKPGIAFSVMRGKL*
8117,8095,22,24355,24287,69,1,-,MLIRKNISLGRPRWEDCLSSGV*
7041,7019,22,21127,21059,69,1,-,MQFSHRRPFGSVYPPVRNKSVF*
6923,6901,22,20773,20705,69,1,-,MESKKGFLSVLISLKKKKKFKS*
6326,6304,22,18982,18914,69,1,-,MFHWKYKKTIQPHTGIWLEKGE*
1987,1965,22,5965,5897,69,1,-,MNEYLKVRTDQYMQIKFTHLKN*
8044,8022,22,24135,24067,69,2,-,MSETPSLRKIKYKKKKNPYSFK*
7488,7466,22,22467,22399,69,2,-,MTHDQQTVLCVSLEFKRSYVRD*
5984,5962,22,17955,17887,69,2,-,MYSDYSYSFVSLSWFLLRHQQI*
5450,5428,22,16353,16285,69,2,-,MGWQLLTNYQVHVEMHLIFLSR*
3835,3813,22,11508,11440,69,2,-,MPVSIMILYSFHYTLINLKKNS*
1080,1058,22,3243,3175,69,2,-,MLEDLTPLISLFLYFYLIFAYF*
10207,10185,22,30623,30555,69,3,-,MITLALCPTLLMALGGPWLILS*
7168,7146,22,21506,21438,69,3,-,MAFPNSSHSFPVGLFLFIFWGI*
2199,2177,22,6599,6531,69,3,-,MDGSRDGCTTMLNVLNTTELYT*
5851,5872,21,17551,17616,66,1,+,MVVVHACGAPAGVERWLGYGR*
7487,7508,21,22459,22524,66,1,+,MGHPSENRTLNLSISKTSLII*
7885,7906,21,23654,23719,66,2,+,MAYCLPYRNLKVRQLNIFNGT*
8215,8236,21,24644,24709,66,2,+,MMGFQADSGSLDENNERLAGR*
9783,9804,21,29348,29413,66,2,+,MILKSSHLIQTMSFYLIGNIY*
11571,11592,21,34712,34777,66,2,+,MFVKITLKLIQMWRKADYRTI*
5865,5886,21,17595,17660,66,3,+,MAWVRKVKAAVSRDYTPPQPG*
14847,14868,21,44541,44606,66,3,+,MSIKHSWNVNFSPLQLTNCHL*
7423,7402,21,22273,22208,66,1,-,MPMKDGHTKTVVVAQRGGSRL*
10190,10169,21,30573,30508,66,2,-,MADPVLRQIKTPVVKQLVEKK*
10009,9988,21,30030,29965,66,2,-,MFSLKLFVHIKEVFTYTYLYM*
7926,7905,21,23781,23716,66,2,-,MTVLILSSLKEDLSSSQCPSC*
4707,4686,21,14124,14059,66,2,-,MLTNSIACYREIFCEMKSQSV*
2880,2859,21,8643,8578,66,2,-,MPGCDYSLFKVCLIGDFIYLL*
656,635,21,1971,1906,66,2,-,MFFNIKTNNPKFLNVFLVSKS*
15879,15858,21,47639,47574,66,3,-,MQFCFSSTERNCKVMKDYILS*
15295,15274,21,45887,45822,66,3,-,MLPFLYFGNMLCTTQLINKSK*
12075,12054,21,36227,36162,66,3,-,MGRLLEYTEQSRSSFRCLFGL*
5781,5760,21,17345,17280,66,3,-,MIIAHCSLKFLGSNDLPTSAF*
2567,2546,21,7703,7638,66,3,-,MPNTRKSGSVIIFVLSYDSCL*
1722,1742,20,5164,5226,63,1,+,MPVMIALWEAEVDGSLETKS*
2461,2481,20,7381,7443,63,1,+,MSHINKYPHSSLGNRARPSL*
8785,8805,20,26353,26415,63,1,+,MASEGREKDNQFESKVLNLV*
11187,11207,20,33559,33621,63,1,+,MILNSSFLKKSIFTCHSSNK*
4906,4926,20,14717,14779,63,2,+,MKTIHLCQSSWATRRIIKEQ*
5704,5724,20,17111,17173,63,2,+,MGTGTGNGRGRGKDCLRSGV*
6931,6951,20,20792,20854,63,2,+,MPCLLLPTIKVTPRTRFTDS*
14044,14064,20,42131,42193,63,2,+,MTVMECNVIISAHCNLHLPG*
15259,15279,20,45776,45838,63,2,+,MNYIVQQIFVNMYINLIYSY*
2005,2025,20,6015,6077,63,3,+,MADIKADFINIHLLCCCLYL*
7247,7267,20,21741,21803,63,3,+,MELLYGTLLKNFFPSQHGLF*
15668,15688,20,47004,47066,63,3,+,MPVIPPLWEAKTGGSPEVGS*
12778,12758,20,38338,38276,63,1,-,MYVSFSYVLFSFEKTKKLDV*
4861,4841,20,14587,14525,63,1,-,MDLDKVNGKPSERIEHSGCH*
3454,3434,20,10366,10304,63,1,-,MKDFSVFYKCVGHFLISVFF*
15475,15455,20,46428,46366,63,2,-,MHRYLDDFCLWTLHKISFSV*
14052,14032,20,42159,42097,63,2,-,MMTLHSITVIVMSRAQKKIL*
10338,10318,20,31017,30955,63,2,-,MLKDLYFAKSPCVFYFNFLG*
2462,2442,20,7389,7327,63,2,-,MAHFSLTLWVQVILPLQPLK*
15400,15380,20,46202,46140,63,3,-,MLFYRHLNCGWVKIRFNISL*
8959,8939,20,26879,26817,63,3,-,MGYSEGKGSSLFLEVVYMYI*
1721,1701,20,5165,5103,63,3,-,MSHCAWPFSYVFYFCKIAFS*
1316,1296,20,3950,3888,63,3,-,MSAHCNLHLLGSSDSLASAS*
6991,7010,19,20971,21030,60,1,+,MWYIASLRKDFILYRLFDL*
8408,8427,19,25222,25281,60,1,+,MVAHACNPSTLGGQGKCTT*
12792,12811,19,38374,38433,60,1,+,MLDSKVRKEDGGGAKDTRM*
5,24,19,14,73,60,2,+,MFISYRVFVKFISFKMIKS*
5653,5672,19,16958,17017,60,2,+,MMACVYSPCHSGGQGRRIA*
1628,1647,19,4884,4943,60,3,+,MKIIRSKHTCFKCTYTICQ*
12562,12543,19,37690,37631,60,1,-,MVNICLPWISFYHVPDSFI*
10349,10330,19,31051,30992,60,1,-,MKKFFPCEQCFNVERFVFC*
3668,3649,19,11008,10949,60,1,-,MLLLCFNVTPSRYSAHTKK*
193,174,19,583,524,60,1,-,MWLSLFFYKVRHSHSVLGK*
14026,14007,19,42081,42022,60,2,-,MSTYICQHISIAVKLLMGQ*
13524,13505,19,40575,40516,60,2,-,MVAHACNPSTWGGCGRWST*
4038,4019,19,12117,12058,60,2,-,MLLLTWVCSYHFLTLIFYF*
3951,3932,19,11856,11797,60,2,-,MFIYFFISSQKFELVIMLY*
10084,10065,19,30254,30195,60,3,-,MYRVFFALNHGVQFTFHYF*
2016,1997,19,6050,5991,60,3,-,MNINKISFYVCHDINCQIC*
1123,1141,18,3367,3423,57,1,+,MHSFQLYLIIKNVKKQDH*
3404,3422,18,10210,10266,57,1,+,MRIYNGTSKQNPKTMQSG*
5436,5454,18,16306,16362,57,1,+,MHFNMYLIICQQLPPHYQ*
6611,6629,18,19831,19887,57,1,+,MDNLFLSDLILLQLPCLG*
697,715,18,2091,2147,57,3,+,MLLLNYRSITILLYCYLL*
4195,4213,18,12585,12641,57,3,+,MRVLHFFHLKDMYVMSTT*
7981,7999,18,23943,23999,57,3,+,MQQVFGYQTEAANNRDLC*
8027,8045,18,24081,24137,57,3,+,MGFFFFCILFFLEMGSHS*
14634,14652,18,43902,43958,57,3,+,MYQKFQLGKQKKKNPLYF*
15969,15987,18,47907,47963,57,3,+,MSFSVNLIPRNINENWCQ*
9728,9710,18,29188,29132,57,1,-,MDTAGFPVQLQKVKEGVI*
1711,1693,18,5137,5081,57,1,-,MFFISVKLLFLSSEVYNH*
15441,15423,18,46326,46270,57,2,-,MKMWPTNIKFVEKLEREN*
15127,15109,18,45384,45328,57,2,-,MVPLYFSLGDRARLHQKE*
12829,12811,18,38490,38434,57,2,-,MYHDLGHHSSISAFLILP*
8205,8187,18,24618,24562,57,2,-,MSFSNYLFEHLNLLVSKC*
6847,6829,18,20544,20488,57,2,-,MLNLVCIPEVLNAHMYTF*
4974,4956,18,14925,14869,57,2,-,MMLNPLCPCSRNGATKPG*
159,141,18,480,424,57,2,-,MHHHLIGSNSGCKTWLLN*
10151,10133,18,30455,30399,57,3,-,MVKMMPLKSRQKVCENPR*
9591,9573,18,28775,28719,57,3,-,MLVIYLLLFLKFFPHLKI*
5319,5301,18,15959,15903,57,3,-,MPCFQWHVLTWCLCVTFR*
2638,2620,18,7916,7860,57,3,-,MVLSLCGKMRKTNGEDDG*
120,137,17,358,411,54,1,+,MHMSPPPVLSLHYHFDT*
3176,3193,17,9526,9579,54,1,+,MILLSLVWFSWCYVNPI*
8250,8267,17,24748,24801,54,1,+,MRSGLLNICKNPSQVFG*
9129,9146,17,27385,27438,54,1,+,MIAPLHSSLGDRVRLCL*
15287,15304,17,45859,45912,54,1,+,MFPKYKKGSIKLADCPS*
15982,15999,17,47944,47997,54,1,+,MKTGANKKTSKQAEKLP*
2274,2291,17,6821,6874,54,2,+,MMAPLHSSLGDRTRPCL*
5318,5335,17,15953,16006,54,2,+,MASTELLDTGFPQTFNL*
5497,5514,17,16490,16543,54,2,+,MGPGKVDHTSNNSILGG*
9066,9083,17,27197,27250,54,2,+,MHVFIFIILQKYYIRNF*
14096,14113,17,42287,42340,54,2,+,MTVMSRAQKKILQLISV*
15307,15324,17,45920,45973,54,2,+,MKLAWFQKIQELQCKNK*
371,388,17,1113,1166,54,3,+,MFIPPLCHIPGSFTNVT*
7903,7920,17,23709,23762,54,3,+,MEPNKMDIGLNLNLLLG*
11736,11753,17,35208,35261,54,3,+,MSYQAIKRRRRNLNVYY*
15459,15476,17,46377,46430,54,3,+,MIFYVMSIDKNHPDTYA*
15979,15962,17,47941,47888,54,1,-,MFLGIKLTEKLISCCYS*
8892,8875,17,26680,26627,54,1,-,MMLDLGNIYLYNIRIVL*
8370,8353,17,25114,25061,54,1,-,MFFLSDNLLLIPVCPKT*
5188,5171,17,15568,15515,54,1,-,MSKANTGQKLGLLYQIS*
9592,9575,17,28779,28726,54,2,-,MNVSDLSSIVLKIFSSS*
4228,4211,17,12687,12634,54,2,-,MSFSVSWVSRYSRESVM*
12405,12388,17,37217,37164,54,3,-,MSITSHRFIGNSPLFSL*
11811,11794,17,35435,35382,54,3,-,MTCICGYNIVQNNFTKP*
7505,7488,17,22517,22464,54,3,-,MRLVLDMLRLRVLFSLG*
4963,4946,17,14891,14838,54,3,-,MEQQSLDDSASIYSMVY*
4579,4562,17,13739,13686,54,3,-,MMIWNWTHNISKVCLYI*
2929,2912,17,8789,8736,54,3,-,MNFYLFIFIICSKCIYM*
1686,1702,16,5056,5106,51,1,+,MLHAKGECSSGYILHC*
6798,6814,16,20392,20442,51,1,+,MVVYQYNARRWFKTMR*
5269,5285,16,15806,15856,51,2,+,MFMAPQNNYNSNIKDH*
5810,5826,16,17429,17479,51,2,+,MLVHACNPSILRGRGG*
8569,8585,16,25706,25756,51,2,+,MIYMGTKKYFKKQVLF*
10396,10412,16,31187,31237,51,2,+,MMCTNCAVSKNTTKIQ*
14771,14787,16,44312,44362,51,2,+,MCGPPSPAPFFFWRHD*
65,81,16,195,245,51,3,+,MYKTFSSLLSNDTYKE*
280,296,16,840,890,51,3,+,MNGTAFLLEPFLTKAK*
1492,1508,16,4476,4526,51,3,+,MSAGLAWWLTPVISAL*
5406,5422,16,16218,16268,51,3,+,MLSEEPSKLNIYFIIL*
9767,9783,16,29301,29351,51,3,+,MSRRTDTVRTEKDGAL*
11478,11494,16,34434,34484,51,3,+,MFPGLQSGIQPSIYLV*
13646,13662,16,40938,40988,51,3,+,MLIQSLLYFSINWFPL*
16154,16138,16,48466,48416,51,1,-,MVACGFANGLPVCFDF*
14369,14353,16,43111,43061,51,1,-,MGFHHIGQAGLELLTS*
11395,11379,16,34189,34139,51,1,-,MPVVPAIQYRLLSLGV*
10168,10152,16,30508,30458,51,1,-,MHEKEAKQEGKKKNES*
7909,7893,16,23731,23681,51,1,-,MSILLGSIENIKLPNF*
6645,6629,16,19939,19889,51,1,-,MEYLFKFISKHFILEC*
5489,5473,16,16471,16421,51,1,-,MAGCRGFCFEKRLNYF*
15547,15531,16,46644,46594,51,2,-,MLGYRREPPSLAWIFF*
12777,12761,16,38334,38284,51,2,-,MYLSAMCCLVLKKLKS*
12333,12317,16,37002,36952,51,2,-,MFIFIASCNCYIHAKS*
10935,10919,16,32808,32758,51,2,-,MGFHHVSHVGLELLTS*
7728,7712,16,23187,23137,51,2,-,MRIENGSLEFGLWSVL*
4789,4773,16,14370,14320,51,2,-,MEPEDVTELLQSHEKT*
9229,9213,16,27689,27639,51,3,-,MLLFFNSFNPHCDPRR*
7138,7122,16,21416,21366,51,3,-,MLMVGRKWQFRNIVTI*
5439,5423,16,16319,16269,51,3,-,MLKCISFFCLGEVTKH*
1142,1126,16,3428,3378,51,3,-,MTQWSCFLTFLIIKYN*
10099,10114,15,30295,30342,48,1,+,MFFIFLSFFQVLFTF*
13909,13924,15,41725,41772,48,1,+,MLIMSSIKITCLAKN*
2542,2557,15,7625,7672,48,2,+,MFHCTINRSHMTEQK*
3674,3689,15,11021,11068,48,2,+,MYMILKKDVQVRIFR*
6357,6372,15,19070,19117,48,2,+,MPVIPALCEAEVGGS*
6636,6651,15,19907,19954,48,2,+,MLGNKLEKIFHNLLA*
10877,10892,15,32630,32677,48,2,+,MSLLFKPKATRRFII*
11013,11028,15,33038,33085,48,2,+,MPVIPTLWEANTGGS*
12412,12427,15,37235,37282,48,2,+,MPNEYTVQWMKTDLY*
13257,13272,15,39770,39817,48,2,+,MPVIPALWEAEAGRS*
1206,1221,15,3618,3665,48,3,+,MMTNQLFSLMEPHIA*
3174,3189,15,9522,9569,48,3,+,MDDSTILSLVLLVLC*
8733,8748,15,26199,26246,48,3,+,MWLKERVHETKELEW*
9734,9749,15,29202,29249,48,3,+,MLHMAKTAAIISTRY*
13645,13630,15,40939,40892,48,1,-,MSHIKDIIWHRLSSV*
9259,9244,15,27781,27734,48,1,-,MASQVTIHLTFLATL*
3712,3697,15,11140,11093,48,1,-,MTREVLFETMKGKTL*
1615,1600,15,4849,4802,48,1,-,MFKTHICRVLLNLFL*
735,720,15,2209,2162,48,1,-,MQSAQGLSLLCSLLI*
12760,12745,15,38283,38236,48,2,-,MFKGKMVLPLLDEGS*
9945,9930,15,29838,29791,48,2,-,MPFLLVYWQSHALAR*
13271,13256,15,39815,39768,48,3,-,MICLPQPPKVLGLQA*
12749,12734,15,38249,38202,48,3,-,MKAHKNDNLNTVFGL*
6513,6498,15,19541,19494,48,3,-,MWIFIYCYLLYFYSK*
6371,6356,15,19115,19068,48,3,-,MIHPPRPRKVLGLQA*
5908,5893,15,17726,17679,48,3,-,MFSNFPKLKTSFVCF*
821,835,14,2461,2505,45,1,+,MKHFEGECNFCFTY*
5826,5840,14,17476,17520,45,1,+,MNCLSLRVQGQPGK*
6236,6250,14,18706,18750,45,1,+,MQDTDRPMDFNVTK*
7127,7141,14,21379,21423,45,1,+,MFLNCHFLPTISIQ*
8722,8736,14,26164,26208,45,1,+,MGWCCVHPGSDQCG*
9178,9192,14,27532,27576,45,1,+,MFPMLESQLCHSQL*
12420,12434,14,37258,37302,45,1,+,MDENRLILRYIIVK*
1134,1148,14,3401,3445,45,2,+,MSKSKTIESCKLEG*
1640,1654,14,4919,4963,45,2,+,MHIYYLPIITELLL*
1970,1984,14,5909,5953,45,2,+,MCKFYLHILICPDF*
2039,2053,14,6116,6160,45,2,+,MVNLLLFLFFMNIC*
3162,3176,14,9485,9529,45,2,+,MAEIMILAVSTDHG*
5370,5384,14,16109,16153,45,2,+,MLLSQDDSPLEELN*
7038,7052,14,21113,21157,45,2,+,MRKLHTAYLNYLFQ*
10828,10842,14,32483,32527,45,2,+,MYLLIKLLCTYYIA*
12551,12565,14,37652,37696,45,2,+,MVKGDPGKTNVYHI*
14844,14858,14,44531,44575,45,2,+,MDIHEYKTFMECQL*
15491,15505,14,46472,46516,45,2,+,MIMHSRKPLWKLTN*
3704,3718,14,11112,11156,45,3,+,MVSNSTSLVILQVN*
4120,4134,14,12360,12404,45,3,+,MVIATSQREGSLGL*
7460,7474,14,22380,22424,45,3,+,MTNTFQTNLSHSSF*
8683,8697,14,26049,26093,45,3,+,MANLKVVKHIFTLK*
11855,11869,14,35565,35609,45,3,+,MLTLGKLYLHRGKE*
12044,12058,14,36132,36176,45,3,+,MFKMYYNKVILKPK*
15219,15233,14,45657,45701,45,3,+,MNPRAKFTWIIEEL*
9832,9818,14,29500,29456,45,1,-,MKIDYIEMIYSMLR*
9087,9073,14,27265,27221,45,1,-,MPGLFLKISNIILL*
8561,8547,14,25687,25643,45,1,-,MPNKNFYGISHHSF*
6494,6480,14,19486,19442,45,1,-,MLFYFSHLKMYNFT*
5734,5720,14,17206,17162,45,1,-,MRGLAMLLRLFSNS*
2550,2536,14,7654,7610,45,1,-,MTPVYSTVKHPTTL*
2007,1993,14,6025,5981,45,1,-,MSAMTLTAKFAEKG*
38,24,14,118,74,45,1,-,MEIIILRGKFVFEW*
13416,13402,14,40251,40207,45,2,-,MYVYILYLVQLYKV*
10889,10875,14,32670,32626,45,2,-,MNLLVAFGLNSSDI*
9817,9803,14,29454,29410,45,2,-,MYENNVAHGLVVTA*
8773,8759,14,26322,26278,45,2,-,MAFIAPKMKGTLLA*
3468,3454,14,10407,10363,45,2,-,MSLHSRFLYHNLEI*
11091,11077,14,33275,33231,45,3,-,MLECSGAISAHCNL*
10357,10343,14,31073,31029,45,3,-,MMSQGLLHEKIFSM*
9559,9545,14,28679,28635,45,3,-,MPHLLSSYLSKLLH*
4347,4333,14,13043,12999,45,3,-,MEFRSCCPGWSAVA*
174,160,14,524,480,45,3,-,MYSLNMLILMRIGI*
1764,1777,13,5290,5331,42,1,+,MVACACIPSYSGG*
6008,6021,13,18022,18063,42,1,+,MVAHTCNSSTLGG*
9902,9915,13,29704,29745,42,1,+,MVTKILFLGNINL*
15599,15612,13,46795,46836,42,1,+,MEASLEPRSLRLQ*
63,76,13,188,229,42,2,+,MYYVQNIFKFAFK*
1498,1511,13,4493,4534,42,2,+,MVAHACNLSTLKG*
2434,2447,13,7301,7342,42,2,+,MVACTCSPSYLRG*
3336,3349,13,10007,10048,42,2,+,MVTPNYIINDSLH*
3831,3844,13,11492,11533,42,2,+,MIDTGIALTNREF*
4311,4324,13,12932,12973,42,2,+,MVVHACIPSYLGG*
11986,11999,13,35957,35998,42,2,+,MSYAHKPGRKLSI*
13393,13406,13,40178,40219,42,2,+,MYLTKLDISSYTL*
15361,15374,13,46082,46123,42,2,+,MKIKLQRNTTYWR*
3037,3050,13,9111,9152,42,3,+,MTETVIILEGIQE*
3344,3357,13,10032,10073,42,3,+,MTASTRQQKKTGY*
5026,5039,13,15078,15119,42,3,+,MASSSSRRLFRLH*
5750,5763,13,17250,17291,42,3,+,MVVHTCGPSYLES*
10361,10374,13,31083,31124,42,3,+,MIQKTVLLKVLFN*
10946,10959,13,32838,32879,42,3,+,MVAHACNPSYLGG*
11902,11915,13,35706,35747,42,3,+,MPRLECSGTITAH*
12259,12272,13,36777,36818,42,3,+,MVVGTCNPSYSRG*
12746,12759,13,38238,38279,42,3,+,MSLHPIVAIPSFP*
14591,14578,13,43777,43736,42,1,-,MEKPCLYLTKLQN*
14575,14562,13,43729,43688,42,1,-,MVAHACNPSFLGG*
7953,7940,13,23863,23822,42,1,-,MKSYMEECGEHLF*
5503,5490,13,16513,16472,42,1,-,MIHLSWPHRSLCV*
3952,3939,13,11860,11819,42,1,-,MNVHLFFYLLTKV*
2186,2173,13,6562,6521,42,1,-,MYLTPLNCTLKGG*
796,783,13,2392,2351,42,1,-,MVNIICVVIYNIC*
90,77,13,274,233,42,1,-,MVFCKLENLIYSL*
14717,14704,13,44154,44113,42,2,-,MGGSPEPGRSELQ*
7650,7637,13,22953,22912,42,2,-,MVAHICNPSYLGG*
5148,5135,13,15447,15406,42,2,-,MIRKQNSLIADIE*
1656,1643,13,4971,4930,42,2,-,MYAHNNNSVIIGK*
12140,12127,13,36422,36381,42,3,-,MVAGTYNPSYLGG*
8740,8727,13,26222,26181,42,3,-,MNPLFQPHWSLPG*
7781,7768,13,23345,23304,42,3,-,MLRKIEDFPNFVA*
7359,7346,13,22079,22038,42,3,-,MVADACNPSCSGG*
5539,5526,13,16619,16578,42,3,-,MSSRDEVSLCCPG*
758,745,13,2276,2235,42,3,-,MHVIQVCHVFVII*
224,236,12,670,708,39,1,+,MLFTWKTPQKKT*
1143,1155,12,3427,3465,39,1,+,MQIGRLKKKIFV*
3592,3604,12,10774,10812,39,1,+,MNVLKYSQSLWF*
5346,5358,12,16036,16074,39,1,+,MRYACIIFSLMP*
14020,14032,12,42058,42096,39,1,+,MLTYICRHIYQN*
333,345,12,998,1036,39,2,+,MFRKSHKHRSLI*
2975,2987,12,8924,8962,39,2,+,MLVNSVHTYVYI*
5898,5910,12,17693,17731,39,2,+,MTFLVLENLKTS*
9856,9868,12,29567,29605,39,2,+,MSFKSRTTRVYG*
14366,14378,12,43097,43135,39,2,+,MVKPHLYYKYKN*
1108,1120,12,3324,3362,39,3,+,MVTKVLIIKFAL*
2852,2864,12,8556,8594,39,3,+,MNTKWPSPIINI*
3924,3936,12,11772,11810,39,3,+,MTRLKLCKTNKA*
4034,4046,12,12102,12140,39,3,+,MLKATLFTKVKR*
4059,4071,12,12177,12215,39,3,+,MYIYTQWNTKKP*
8446,8458,12,25338,25376,39,3,+,MQKLAGRGSTRL*
9028,9040,12,27084,27122,39,3,+,MVDSEVKYRNAK*
9934,9946,12,29802,29840,39,3,+,MHVTANKLVKKA*
12624,12636,12,37872,37910,39,3,+,MLKCPAQTFIST*
14746,14758,12,44238,44276,39,3,+,MLARLVSNSGLK*
14906,14918,12,44718,44756,39,3,+,MLISTSQKSLYD*
15048,15060,12,45144,45182,39,3,+,MFFAYSFLSKLE*
14907,14895,12,44725,44687,39,1,-,MSMGYSLILISE*
14730,14718,12,44194,44156,39,1,-,MVVHTCVLASGG*
11822,11810,12,35470,35432,39,1,-,MLYSLWVLSNVK*
11337,11325,12,34015,33977,39,1,-,MTLLKLQFTLKL*
9384,9372,12,28156,28118,39,1,-,MLDFNVLYAVPW*
8072,8060,12,24220,24182,39,1,-,MVPICSPSYRGS*
7060,7048,12,21184,21146,39,1,-,MFPLFIMEDLLK*
4642,4630,12,13930,13892,39,1,-,MIVSIFSNRIFN*
4313,4301,12,12943,12905,39,1,-,MHHHAWLVLYFS*
2621,2609,12,7867,7829,39,1,-,MANYIEQTAETK*
634,622,12,1906,1868,39,1,-,MTTFFFFFFFFF*
13981,13969,12,41946,41908,39,2,-,MYIFSYSSFSDE*
10906,10894,12,32721,32683,39,2,-,MREPLCPACKFF*
4160,4148,12,12483,12445,39,2,-,MLSTFCNQLLCN*
2659,2647,12,7980,7942,39,2,-,MIISQSQGNNVV*
2172,2160,12,6519,6481,39,2,-,MVNFMLFVFYHN*
2125,2113,12,6378,6340,39,2,-,MAKPCLYKKYKN*
14546,14534,12,43640,43602,39,3,-,MSAIALQPGQQD*
11309,11297,12,33929,33891,39,3,-,MESCSVAQAGMQ*
10949,10937,12,32849,32811,39,3,-,MRHHAQLILCFW*
10292,10280,12,30878,30840,39,3,-,MSDARLAGIPLL*
9857,9845,12,29573,29535,39,3,-,MTCLLFQDFRFV*
9091,9079,12,27275,27237,39,3,-,MSHHAWPFFKNF*
8618,8606,12,25856,25818,39,3,-,MVGFCSRVLFLN*
7228,7216,12,21686,21648,39,3,-,MYRVRTGDLKLD*
5493,5481,12,16481,16443,39,3,-,MCLNGWVQRFLF*
5049,5037,12,15149,15111,39,3,-,MKEVYTKNRFSV*
4202,4190,12,12608,12570,39,3,-,MKEMENSHYLPL*
3118,3106,12,9356,9318,39,3,-,MLFCYFDTWEIV*
53,41,12,161,123,39,3,-,MAIRPKDKPNCR*
6552,6563,11,19654,19689,36,1,+,MQLLKSLKKKA*
8632,8643,11,25894,25929,36,1,+,MSKFHWKLHPK*
12404,12415,11,37210,37245,36,1,+,MDMSGHIKNAQ*
181,192,11,542,577,36,2,+,MTVPYFIKKQR*
469,480,11,1406,1441,36,2,+,MPSCFLTIVDR*
4057,4068,11,12170,12205,36,2,+,MKNVYIHTMEY*
10001,10012,11,30002,30037,36,2,+,MCTNNFNENII*
11959,11970,11,35876,35911,36,2,+,MLPRLVLNSWA*
12371,12382,11,37112,37147,36,2,+,MKFPRELVQEI*
13413,13424,11,40238,40273,36,2,+,MYTYICTHQNF*
2983,2994,11,8949,8984,36,3,+,MYIYKKLRREV*
6963,6974,11,20889,20924,36,3,+,MKKKCGFWCYY*
11200,11211,11,33600,33635,36,3,+,MSQFKQMSSYC*
11214,11225,11,33642,33677,36,3,+,MCFAGCGGSRL*
11728,11717,11,35188,35153,36,1,-,MFHFLDALQFI*
9530,9519,11,28594,28559,36,1,-,MDHFSAKLLDC*
5149,5138,11,15451,15416,36,1,-,MNDKKTKQPYC*
4835,4824,11,14509,14474,36,1,-,MGGQNINMNKS*
4560,4549,11,13684,13649,36,1,-,MLGIYKLLCIM*
3475,3464,11,10429,10394,36,1,-,MLQLHVVNVIT*
770,759,11,2314,2279,36,1,-,MKHVCFTDFCF*
213,202,11,643,608,36,1,-,MFITIFNKLNR*
15712,15701,11,47139,47104,36,2,-,MCHHARLILYF*
13665,13654,11,40998,40963,36,2,-,MHRFTKETNLY*
13399,13388,11,40200,40165,36,2,-,MSSLVRYMILS*
11850,11839,11,35553,35518,36,2,-,MAHLLELMNLN*
10751,10740,11,32256,32221,36,2,-,MCHHALLILYF*
9133,9122,11,27402,27367,36,2,-,MQWCYHSSPQP*
8966,8955,11,26901,26866,36,2,-,MKVMEDTNGVF*
5103,5092,11,15312,15277,36,2,-,MKAERGGDAAE*
289,278,11,870,835,36,2,-,MAQVEKQSHSY*
14871,14860,11,44615,44580,36,3,-,MQYSKVTVCQL*
14005,13994,11,42017,41982,36,3,-,MLAQNLVRSIN*
9911,9900,11,29735,29700,36,3,-,MLPRKRIFVTI*
8721,8710,11,26165,26130,36,3,-,MASLLLPILPT*
2241,2230,11,6725,6690,36,3,-,MNDFLRRKFCF*
1526,1515,11,4580,4545,36,3,-,MLPRLVMNSWT*
282,292,10,844,876,33,1,+,MGLLFYLSHF*
2054,2064,10,6160,6192,33,1,+,MVWFFVVVVV*
3370,3380,10,10108,10140,33,1,+,MNGYCGNDLQ*
6816,6826,10,20446,20478,33,1,+,MHIQTEKSTV*
10345,10355,10,31033,31065,33,1,+,MEKIFSCKSP*
13109,13119,10,39325,39357,33,1,+,MIQGKVYLSQ*
13617,13627,10,40849,40881,33,1,+,MRWLGKIGRR*
14798,14808,10,44392,44424,33,1,+,MVGIGVGRTS*
526,536,10,1577,1609,33,2,+,MNTEVQDKGE*
4072,4082,10,12215,12247,33,2,+,MKEILTLHKT*
5075,5085,10,15224,15256,33,2,+,MGVTFLIPYN*
5764,5774,10,17291,17323,33,2,+,MWEGHLSPEI*
6609,6619,10,19826,19858,33,2,+,MIWITCFFLT*
8119,8129,10,24356,24388,33,2,+,MTCTRISISL*
10222,10232,10,30665,30697,33,2,+,MHFLTAPSNM*
11939,11949,10,35816,35848,33,2,+,MPPHPASFLY*
227,237,10,681,713,33,3,+,MEDTTKEDII*
3681,3691,10,11043,11075,33,3,+,MYKLEYLDNC*
6398,6408,10,19194,19226,33,3,+,MVAHTCGSGY*
7303,7313,10,21909,21941,33,3,+,MTTTVSFFFF*
8642,8652,10,25926,25958,33,3,+,MTDLRFYQGI*
9165,9175,10,27495,27527,33,3,+,MRCTASDHTL*
12400,12410,10,37200,37232,33,3,+,MRSDGHEWPY*
15915,15925,10,47745,47777,33,3,+,MLFTDTSVVG*
15950,15940,10,47854,47822,33,1,-,MKNKYVKYTF*
15483,15473,10,46453,46421,33,1,-,MGFSCLSHHA*
14129,14119,10,42391,42359,33,1,-,MYTYVFLGVF*
10222,10212,10,30670,30638,33,1,-,MHGLLKRTED*
9066,9056,10,27202,27170,33,1,-,MHTICKPEFD*
7458,7448,10,22378,22346,33,1,-,MEATLVNKFP*
2197,2187,10,6595,6563,33,1,-,MVVGMVVQQC*
9380,9370,10,28143,28111,33,2,-,MSFMLFLGNR*
8555,8545,10,25668,25636,33,2,-,MVFHIIRFKI*
6900,6890,10,20703,20671,33,2,-,MKSLGTSVSL*
6497,6487,10,19494,19462,33,2,-,MLRCYFIFHI*
5270,5260,10,15813,15781,33,2,-,MNIGDIRWQT*
1139,1129,10,3420,3388,33,2,-,MVLLFDIFNN*
8136,8126,10,24410,24378,33,3,-,MVSVLGDFIG*
269,259,10,809,777,33,3,-,MCTVNCLLDN*
