Start (AA),Stop (AA),AA Length,Start (NT),Stop (NT),NT Length,Reading Frame,Strand,Amino Acid Sequence
497,364,133,1494,1093,402,1,-,MKLVVRPWAGWYQGYKTGLRRPIETGHVETEKTLGFLIGTDSLCLLVYFPTLRLLVVYPWTQRFFESFGDLSTPDAVMGNPKVKAHGKKVLGAFSDGLAHLDNLKGTFATLSELHCDKLHVDPENFRVSLWDA*
115,53,62,348,160,189,1,-,MVGIRLDYSESKLGPFANHVHTSYLPPTAPGQRAGLCAGPSLWQRIHPTSAGCLSESGGWCG*
519,458,61,1558,1373,186,3,-,MVHLTPEEKSAVTALWGKVNVDEVGGEALGRLVSRLQDRFKETNRNWACGDREDSWVSDRH*
97,45,52,293,135,159,2,-,MFIPLIFLPQLLGNVLVCVLAHHFGKEFTPPVQAAYQKVVAGVANALAHKYH*
338,290,48,1017,871,147,1,-,MGNRRMIASVWKSQDRFSFFYLLFITIVFFCLILAFFFFLLRNFYYYT*
413,454,41,1237,1362,126,1,+,MSLHLRVAHNSIRSGQIPKGLKEPLGPRVDHQQPKGGKIDQ*
175,138,37,527,414,114,2,-,MIQCIMPLCTILKNNSDNFWVKAIAISLHINISAYKL*
412,387,25,1238,1161,78,2,-,MARKCSVPLVMAWLTWTTSRAPLPH*
132,155,23,395,466,72,2,+,MKPLTSVTIYMQKYLYAEILLLP*
76,99,23,228,299,72,3,+,MGQHTDQHVAQELWEEDKRYEHD*
207,228,21,621,686,66,3,+,MQNYPDLVNMCTHIKTLHFNP*
352,372,20,1056,1118,63,3,+,MNLTIEKKGKENIKRPIDSP*
255,236,19,766,707,60,3,-,MCAYLHIHNLPTLFSFIFN*
166,184,18,496,552,57,1,+,MVQRGMIHCIIIALKERD*
368,350,18,1105,1049,57,3,-,MGRLMFSFPFFSMVKFMS*
53,35,18,160,104,57,3,-,MPWPTSITKLAFLLSNFY*
147,164,17,441,494,54,3,+,MQRYCYCLNPEIITVIL*
232,248,16,696,746,51,3,+,MIMYQLKIKENKVGRL*
14,29,15,41,88,48,2,+,MLKALHNIPQFSSWT*
248,263,15,743,790,48,2,+,MNMQISTHIFQIVMY*
6,20,14,16,60,45,1,+,MFFIRQNPDAQGPS*
219,205,14,659,615,45,2,-,MCTHIDQIRVILHL*
201,187,14,605,561,45,2,-,MLSSFNILFCLSYF*
230,243,13,689,730,42,2,+,MYNDYVSIKNKRK*
275,288,13,825,866,42,3,+,MYLRDISFCYTQC*
172,161,11,519,484,36,1,-,MYHASLHHSKE*
471,461,10,1415,1383,33,2,-,MWRQRRLLGF*
19,9,10,58,26,33,3,-,MKGLEHLDSA*
