Start (AA),Stop (AA),AA Length,Start (NT),Stop (NT),NT Length,Reading Frame,Strand,Amino Acid Sequence
44,53,9,130,159,30,1,+,MFFQQERQQ*
23,196,173,68,589,522,2,+,MQLNKVLKGLMIALPVMAIAACSSNKNASNDGSEGMLGAGTGMDANGGNGNMSSEEQARLQMQQLQQNNIVYFDLDKYDIRSDFAQMLDAHANFLRSNPSYKVTVEGHADERGTPEYNISLGERRANAVKMYLQGKGVSADQISIVSYGKEKPAVLGHDEAAYSKNRRAVLVY*
52,127,75,156,383,228,3,+,MTAAKACWVPALVWMRTAATATCLPKSRLVCKCNSCSRTTSFTSIWTSTISVLTSLKCWMHMQTSCVATRLTKSP*
180,200,20,540,602,63,3,+,MTKRHTPKTVVRYWFTKRIA*
38,71,33,112,213,102,1,-,MPLRHDPVLQVFLYRKKRWRSGLQKRLYPAGTS*
179,184,5,535,552,18,1,-,MPQLP*
16,221,205,47,664,618,2,-,MSEVTAHAILLVNQYRTTVFGVCRFVMTQYCRFFFTVRNDGDLVCRNAFTLQVHLNGVRTTFTQGDVVFRSTTFVRVTFYGDFVRRVATQEVCMCIQHLSEVRTDIVLVQIEVNDVVLLQLLHLQTSLLFGRHVAVAAVRIHTSAGTQHAFAAVIAGVLVGRTCRNCHNRQSNHQPFQHFVQLHFNDSFTIQLIIITDTATRQGI*
22,26,4,66,80,15,3,-,MQFS*
55,92,37,165,278,114,3,-,MEIWSAETPLPCRYILTAFARRSPREMLYSGVPRSSA*
130,208,78,390,626,237,3,-,MLFCCSCCICRRACSSEDMLPLPPFASIPVPAPSMPSLPSLLAFLLEEHAAIAITGRAIISPFSTLFSCISMIPLLFN*
