Start (AA),Stop (AA),AA Length,Start (NT),Stop (NT),NT Length,Reading Frame,Strand,Amino Acid Sequence
13,181,168,39,545,507,3,+,MYDPKTKNVTKENDSKEGFFTYICGFIQQKLALGGSVAIKITEHSWNADLYKLMGHFAWWTAFVTNVNASSSEAFLIGCNYLGKPREQIDGYVMHANYIFWRNTNPIQLSSYSLFDMSKFPLKLRGTAVMSLKEGQINDMILSLLSKGRLIIRENNRVVISSDVLVNN*
309,396,87,926,1189,264,2,+,MLLLKSVNFNFVMIHFWVFITTKTTKVGWKVSSEFILVRIIALLNMSLSLFLWTLKENRVISKILGNLCLRILMVILKYILSTRLLI*
245,284,39,734,853,120,2,+,MLLGSMLYMSLGPMVLRGLITLSYHLMMVFILLPLRSLT*
535,571,36,1604,1714,111,2,+,MLGTGRESATVLLIILSYIIPHHFPLLSVMECLLLN*
589,618,29,1766,1855,90,2,+,MKSDKSLQGKLERLLIIIINYQMILQAAL*
103,130,27,307,390,84,1,+,MVMSCMQITYFGGIQIQFSCLPILYLT*
21,44,23,61,132,72,1,+,MLQKKMTLKRVFSLTFVGLYNKS*
60,80,20,178,240,63,1,+,MLIFISSWDTSHGGQPLLLM*
107,88,19,323,264,60,2,-,MHDITIYLFAWFAKIITSN*
418,401,17,1256,1203,54,2,-,MLIPIGKSTNGSKAEKP*
557,542,15,1672,1625,48,3,-,MMRNYIGQNNQQHSC*
409,394,15,1228,1181,48,3,-,MVLKPKNPEGDHALN*
468,454,14,1406,1362,45,2,-,MVPFSLYFNRKVLG*
572,585,13,1715,1756,42,2,+,MISALLMSMQIHL*
252,239,13,759,718,42,1,-,MYSMEPSNIGKER*
56,43,13,170,129,42,2,-,MFCYLYSHGTSKS*
450,461,11,1349,1384,36,2,+,MWVIFNLGLFY*
323,312,11,970,935,36,3,-,MDHYKIEIHRL*
